.#####......####
######......###.
######......##..
######..........
#####.......##.#
...#...#######.#
........########
........#######.
..........####..
..........####..
##.......####...
##....##########
##..#.##########
##.###.#########
#####...########
####....########
